WWWWWWWWWWWWW
WFFFFFFFFFFFW
WFFFFFFFFFFFW
WFFFFFFFFFFFW
WFFFFFFFFFFFW
WFFFFFFFFFFFW
WFFFFFSFFFFFW
WFFFFFFFFFFFW
WFFFFFFFFFFFW
WFFFFFFFFFFFW
WFFFFFFFFFFFW
WFFFFFFFFFFFW
WWWWWWWWWWWWW
