{
	"Grid": [
		"WWWWWWWWWWW",
		"WWWWWGWWWWW",
		"WWWWWDWWWWW",
		"WFFFFFFFFFW",
		"WFFFFFFFFFW",
		"WFFFFFFFFFW",
		"WFFFFFFFFFW",
		"WFFFF^FFFFW",
		"WFFFFFFFFFW",
		"WFFFFFFFFFW",
		"WFFFFFFFFFW",
		"WFFFFFFFFFW",
		"WWWWWWWWWWW"
	],
	"LightMap": [
		"-----------",
		"-----1-----",
		"-----1-----",
		"-111111111-",
		"-111111111-",
		"-111111111-",
		"-111111111-",
		"-111111111-",
		"-111111111-",
		"-111111111-",
		"-111111111-",
		"-111111111-",
		"-----------"
	]
}